100
50
988C000000000000000000000000000000000000000000000000000000000000000000000000000000000000000000000000 0
100400098AA88C00000098C00000000000000000000000000000000000000000000000000000000000000000000000000000 0
1004000149C10400000010400000000000000000000000000000000000000000000000000000000000000000000000000000 0
3222AAA041410400000030600000000000000000000000000000000000000000000000000000000000000000000000000000 0
0000000143610400000005000000000000000000000000000000000000000000000000000000000000000000000000000000 0
00009880088004009AAC05000000000000000000000000000000000000000000000000000000000000000000000000000000 0
0000102222220400500505000000000000000000000000000000000000000000000000000000000000000000000000000000 0
000014BAAAAE1400500505000000000000000000000000000000000000000000000000000000000000000000000000000000 0
0000108888880400500505000000000000000000000000000000000000000000000000000000000000000000000000000000 0
0000322222220600509605000000000000000000000000000000000000000000000000000000000000000000000000000000 0
0000000000090C00505005000000000000000000000000000000000000000000000000000000000000000000000000000000 0
0000000000010400503AA6000000000000000000000000000000000000000000000000000000000000000000000000000000 0
0000000000010400500000000000000000000000000000000000000000000000000000000000000000000000000000000000 0
0000000000030600500000000000000000000000000000000000000000000000000000000000000000000000000000000000 0
00000098AA880088400000000000000000000000000000000000000000000000000000000000000000000000000000000000 0
00098C149C100000400000000000000000000000000000000000000000000000000000000000000000000000000000000000 0
0001000414100022400000000000000000000000000000000000000000000000000000000000000000000000000000000000 0
00032614361004BE500000000000000000000000000000000000000000000000000000000000000000000000000000000000 0
00000032AA2222A8600000000000000000098888C00000000000000000000000000000000000000000000000000000000000 0
0000000000000090C000000000000000009000000C0000000000000000000000000000000000000000000000000000000000 0
000000000000003060000000000000000900000000C000000000000000000000000000000000000000000000000000000000 0
0000000000000005000000000000000090000000000C00000000000000000000000000000000000000000000000000000000 0
00000000000000050000000000000009000000000000C0000000000000000000000000000000000000000000000000000000 0
0000000000000003AAAAAAAAAAAAAAA000000000000040000000000000000000000000000000000000000000000000000000 0
0000000000000000000000000000000300000000000060000000000000000000000000000000000000000000000000000000 0
0000000000000000000000000000000030000000000090000000000000000000000000000000000000000000000000000000 0
0000000000000000000000000000000003000000000900000000000000000000000000000000000000000000000000000000 0
0000000000000000000000000000000000300000009000000000000000000000000000000000000000000000000000000000 0
0000000000000000000000000000000000032222290000000000000000000000000000000000000000000000000000000000 0
0000000000000000000000000000000000000000000000000000000000000000000000000000000000000000000000000000 0
0000000000000000000000000000000000000000000000000000000000000000000000000000000000000000000000000000 0
0000000000000000000000000000000000000000000000000000000000000000000000000000000000000000000000000000 0
0000000000000000000000000000000000000000000000000000000000000000000000000000000000000000000000000000 0
0000000000000000000000000000000000000000000000000000000000000000000000000000000000000000000000000000 0
0000000000000000000000000000000000000000000000000000000000000000000000000000000000000000000000000000 0
0000000000000000000000000000000000000000000000000000000000000000000000000000000000000000000000000000 0
0000000000000000000000000000000000000000000000000000000000000000000000000000000000000000000000000000 0
0000000000000000000000000000000000000000000000000000000000000000000000000000000000000000000000000000 0
0000000000000000000000000000000000000000000000000000000000000000000000000000000000000000000000000000 0
0000000000000000000000000000000000000000000000000000000000000000000000000000000000000000000000000000 0
0000000000000000000000000000000000000000000000000000000000000000000000000000000000000000000000000000 0
0000000000000000000000000000000000000000000000000000000000000000000000000000000000000000000000000000 0
0000000000000000000000000000000000000000000000000000000000000000000000000000000000000000000000000000 0
0000000000000000000000000000000000000000000000000000000000000000000000000000000000000000000000000000 0
0000000000000000000000000000000000000000000000000000000000000000000000000000000000000000000000000000 0
0000000000000000000000000000000000000000000000000000000000000000000000000000000000000000000000000000 0
0000000000000000000000000000000000000000000000000000000000000000000000000000000000000000000000000000 0
0000000000000000000000000000000000000000000000000000000000000000000000000000000000000000000000000000 0
0000000000000000000000000000000000000000000000000000000000000000000000000000000000000000000000000000 0
0000000000000000000000000000000000000000000000000000000000000000000000000000000000000000000000000000 0
0