20
20
11111100000000000000 0
11111100000000000000 0
11111100000000000000 0
00011100000000000000 0
00011111100000000000 0
00011100100000000000 0
00000001110000000000 0
00000001110000000000 0
00000001110000000000 0
00000001110000000000 0
00000000100000000000 0
00000011100000000000 0
00000000000000000000 0
00000000000000000000 0
00000000000000000000 0
00000000000000000000 0
00000000000000000000 0
00000000000000000000 0
00000000000000000000 0
00000000000000000000 0
0