20
20
00000000000000000000 0
00000000000000000000 0
00000000000000000000 0
00000000000000000000 0
00000000000000000000 0
00000000000000000000 0
00000000000000000000 0
00000000000000020000 0
00000000000000080000 0
00000000000000000000 0
00000000000000000000 0
00000000000000000000 0
00000000000000000000 0
00000000000000000000 0
00000000000000000200 0
00000000000000000800 0
00000000000000000000 0
00000000000000000000 0
00000000000000000000 0
00000000000000000000 0
0