20
20
00000000000000000000 0
00000011100000000000 0
00000000000000000000 0
00000011100000000000 0
00000000000000000000 0
00010000000000000000 0
00000000000000000000 0
00000001010000000000 0
00010000000000000000 0
00000000000000000000 0
00000000000000000000 0
10000000000000000000 0
00000000000000000000 0
00000000000000000000 0
00010000000000000000 0
00000000000000000000 0
00000000000000000000 0
00000101000110000000 0
00000000000000010001 0
00000000000000000000 0
0
