20
20
98C98C00000000000000 0
10000400000000000000 0
32630600000000000000 0
00090C00000000000000 0
000100AAC00000000000 0
00032600500000000000 0
000000090C0000000000 0
00000005550000000000 0
00000005550000000000 0
00000003060000000000 0
00000000500000000000 0
000000AA600000000000 0
00000000000000000000 0
00000000000000000000 0
00000000000000000000 0
00000000000000000000 0
00000000000000000000 0
00000000000000000000 0
00000000000000000000 0
00000000000000000000 0
0
