20
20
00000000000000000000 0
00000000000000000000 0
00002000410000000000 0
00008000000000000000 0
00000000000000000000 0
00000000200000000000 0
00000002820000000000 0
00000008080000020000 0
00000000200000080000 0
00000000800000000000 0
00000000000000000000 0
00000000000004100000 0
00000000000000000000 0
00000002041000000000 0
00000008000000000000 0
00000000000000000000 0
00000000000000000000 0
00000000000000000000 0
00000000000000000000 0
00000000000000000000 0
0